0..........00..
......0..000..0
........00F...0
.00...0.....0..
.0.0..0.0......
.........0.0..0
.0......0.....0
....0........0.
.........00....
..0.....00....S
......0.......0
.........0.....
...0.......0...
.....0........0
......0........