..0....F0.
.......0..
......0S0.
...0......
0.......0.
....00...0
..........
.0........
..........
0.......0.