............0.......
0...0.....0.........
..........0000......
.....0......0.....0.
0.......0..0..0..F0.
..0..0.00......0.0..
0....0......0.......
......0.............
....0.....00........
0..........0....0...
....................
...0.........0....0.
....0...0.....00..0.
.000.0..0..0........
0.....00...0.....0.0
..0.................
..............0.....
....................
..00..0.......0.....
0...0.....0...S0..0.